++++++++++++++++++++++
+ S    ++ +++       ++
      +     +++ ++++++
+ +    ++  ++++ +++ ++
+ +   + + ++    + + ++
+          ++   +  +++
+++ + + +      ++  +++
+ +++ +++  + +  ++  ++
+          + +  + +++
+++++ +  + + +      
++++++++++++++++++++