++++++++++++++++++++++
+ S+   ++ +++       ++
      +     +++ ++++++
+ +    ++  ++++ +++ ++
+ +   + + ++    + + ++
+          ++   +  +++
+++ + + +      ++  +++
+ +++ +++  + +  ++  ++
+          + +  + + ++
+++++ +  + + +      
++ +++ +++++++++++++++